#SETTING::name->Level_1
#SETTING::shuffle->false
#SETTING::doGaps->false
#SETTING::infinite->false
#SETTING::autoCoinSpawn->false


#ALIAS::1->Inanimate
#ALIAS::2->FallBox
#ALIAS::3->BreakBox

#ALIAS::10->DefaultCoin
#ALIAS::11->SuperCoin
#ALIAS::12->GoodBoyCoin
#ALIAS::13->ExtraLife

#ALIAS::20->Launcher
#ALIAS::21->MissileLauncher
#ALIAS::22->WeaknessCannon:1
#ALIAS::23->CannonWeakness:1
#ALIAS::24->WeaknessCannon:2
#ALIAS::25->CannonWeakness:2

#ALIAS::30->MrHeli
#ALIAS::31->Apache:Pizza

#ALIAS::40->Jumper

#ALIAS::50->Pizza
#ALIAS::51->MonsterPizza

#ALIAS::100->SpriteDummy:8:5:intro.png


{
{0	0	0	0	0	0	0	0	0	0 }
{0	0	0	0	0	0	0	0	0	0 }
{0	0	0	0	0	0	0	0	0	0 }
{0	0	100	0	0	0	0 	0	0	0 }
{0	0	0	0	0	0	0	0	0	0 }
{0	0	0	0	0	0	0	0	0	0 }
{0	0	0	0	0	0	0	0	0	0 }
{0	0	0	0	0	0	0 	0	0	0 }
{1	1	1	1	1	1	1	1	1	1 }
}
{
{1	1	1	1	1	1	1	0	0	0 }
{1	0	20	0	20	0	1	0	0	0 }
{1	0	0	0	0	0	1	0	0	0 }
{1	0	0	0	0	0	1 	0	0	0 }
{1	0	3	3	3	0	1	0	0	0 }
{0	0	10	10	10	0	0	0	0	0 }
{0	0	10	10	10	0	0	0	0	0 }
{0	0	0	0	0	0	0 	0	0	0 }
{1	1	1	1	1	1	1	1	1	1 }
}
{
{1	0	1	1	1	1	1	0	1 }
{20	0	0	0	11	0	0	0	20 }
{0	0	0	0	10	0	0	0	0 }
{0	0	0	0	10	0	0 	0	0 }
{0	0	0	0	0	0	0	0	0 }
{0	0	0	0	0	0	0	0	0 }
{0	0	0	0	0	0	0	0	0 }
{0	0	1	0	50	0	1 	0	0 }
{1	1	1	1	1	1	1	1	1 }
}
{
{0	0	0	0	0	0	0	0	0	0 }
{0	0	0	0	0	0	10	10	0	0 }
{0	0	0	0	0	0	10	10	0	0 }
{0	0	0	10	10	0	0 	0	0	30 }
{0	0	0	10	10	0	1	1	0	0 }
{0	0	0	0	0	0	0	0	0	0 }
{0	0	0	1	1	30	0	0	0	0 }
{0	0	0	0	0	0	0 	0	0	0 }
{1	1	30	0	0	0	0 	0	0	0 }
}
{
{11	13	0	0	10	0	0	0	0	0 }
{1	1	0	0	10	0	0	0	0	0 }
{0	0	0	0	10	0	0	0	0	0 }
{0	0	0	0	10	0	0 	0	0	0 }
{1	1	0	0	10	0	0	0	0	0 }
{0	0	0	0	10	0	0	0	0	0 }
{0	0	0	0	10	0	0	0	0	0 }
{0	0	0	0	1	0	0 	0	0	0 }
{0	0	0	1	1	30	0	0	0	1 }
}
{
{1	0	20	20	0	0	0	20	20	0 }
{1	0	0	0	0	0	0	0	0	0 }
{1	0	0	0	0	0	0	0	0	0 }
{1	0	0	0	0	0	0 	0	0	0 }
{1	0	10	10	0	0	0	10	10	0 }
{0	0	10	10	0	0	0	10	10	0 }
{0	0	0	0	0	0	0	0	0	0 }
{0	0	0	0	0	0	0 	0	0	0 }
{1	1	1	1	1	1	1	1	1	1 }
}
{
{0	0	20	20	0	0	0	20	20	0 }
{0	0	0	0	0	0	0	0	0	0 }
{0	0	0	0	10	10	10	0	0	0 }
{0	0	0	0	3	3	3 	0	0	0 }
{0	0	0	0	3	13	3	0	0	0 }
{0	0	0	0	3	3	3	0	0	0 }
{0	0	0	0	0	0	0	0	0	0 }
{0	0	0	0	0	0	0 	0	0	0 }
{1	1	1	1	1	1	1	1	1	1 }
}
{
{3}
{3}
{3}
{3}
{3}
{3}
{3}
{3}
{1}
}
{
{0	0	1	0	22	0	1	0	0	0 }
{0	0	1	0	0	0	1	0	0	0 }
{0	0	1	0	0	0	1	0	0	0 }
{0	0	1	0	0	0	1 	0	0	0 }
{0	0	1	1	1	1	1	0	0	0 }
{0	0	0	0	0	0	0	0	0	1 }
{0	0	0	0	0	0	0	0	0	1 }
{0	0	0	0	23	0	0 	0	0	1 }
{1	1	1	1	1	1	1	1	1	1 }
}
{
{0	0	0	0	0	0	0	0	0	0	0 	0	0	0 }
{0	0	0	0	0	0	0	0	0	0	0 	0	0	0 }
{0	0	0	0	0	0	0	0	0	0	0 	0	0	0 }
{0	0	0	0	0	0	0 	0	0	0	0 	0	0	0 }
{0	0	0	0	0	0	0	0	0	0	0 	0	0	0 }
{0	0	0	0	0	0	0	0	0	0	0 	0	0	0 }
{0	0	0	0	0	0	0	0	0	0	0 	0	0	0 }
{0	0	0	0	0	0	0 	0	0	0	0 	0	0	0 }
{1	1	1	1	1	1	1	1	1	1	1	1	1	1 }
}
{
{0	0	0	24	0	24	0	0	0	0	0	0	24	1	1	24	0 }
{0	0	0	0	0	0	0	0	0	0	0	0	0	24	24	0	0 }
{0	0	0	0	0	0	10	10	10	0	0	0	0	0	0	0	0 }
{0	0	0	0	0	0	10	10	10	0	0	0	0	0	0	0	0 }
{0	0	0	0	10	0	0	0	0	0	10	0	0	0	0	0	0 }
{0	0	0	0	10	0	0	0	0	0	10	0	10	10	10	10	0 }
{0	0	0	0	10	0	3	3	3	0	10	0	10	0	0	10	0 }
{0	0	0	0	1	0	3	25	3	0	1	0	10	0	0	10	0 }
{0	0	1	1	1	1	1	1	1	1	1	1	1	0	0	1	1 }
}
{
{0	0	0	0	0	0	0	0	0	0 }
{0	0	0	0	0	0	0	0	0	0 }
{0	0	0	0	0	0	0	0	0	0 }
{0	0	0	0	0	0	0 	0	0	0 }
{0	0	0	0	0	0	0	0	0	0 }
{0	0	0	0	0	0	0	0	0	0 }
{0	0	0	0	0	0	0	0	0	0 }
{0	0	0	0	0	0	0 	0	0	0 }
{1	1	1	1	1	1	1	1	1	1 }
}
{
{0	0	0	0	0	20	0	0	10	0	10	0	0	0	0	0	0	0	0	0 }
{0	0	0	0	0	0	0	0	0	10	0	0	0	0	0	0	0	0	0	0 }
{0	0	0	0	0	0	0	0	10	0	10	0	0	0	10	0	0	0	0	0 }
{0	0	0	0	0	0	0 	0	0	0	0	0	0	10	10	10	0	0	1	1 }
{0	0	0	0	0	0	0	0	1	1	1	0	0	0	10	0	0	0	1	1 }
{0	0	0	0	0	0	0	0	0	0	0	0	0	0	0	0	0	0	1	1 }
{0	0	0	0	0	0	0	0	0	0	0	0	0	1	1	1	0	0	1	1 }
{0	0	0	0	1	1	1 	0	0	0	0	0	0	0	0	0	0	0	1	1 }
{1	1	0	0	1	1	1	0	0	0	0	0	0	0	0	0	0	0	1	1 }
}
{
{0	11	11	0	0	0	0	0	0	0	0	0 	0	0	0 }
{0	10	10	11	11	0	11	11	0	0	0	0 	0	0	0 }
{0	0	0	10	10	11	10	10	11	11	0	0 	0	0	0 }
{0	0	0	0	0	10	0 	0	10	10	0	0 	0	0	0 }
{0	0	0	0	0	0	0	0	0	0	0	0 	0	0	0 }
{0	0	0	0	0	0	0	0	0	0	0	0 	0	0	0 }
{0	0	0	0	0	0	0	0	0	0	0	0 	0	0	0 }
{0	0	0	0	50	0	0 	0	0	0	0	0 	0	0	0 }
{1	1	1	1	1	1	1	1	1	1	1	1	1	1	1 }
}
